NO ./textures/north_texture.xpm
SO ./textures/south_texture.xpm
WE ./textures/west_texture.xpm
EA ./textures/east_texture.xpm

C 1, 38, 46

F 1, 38, 46

1111111111111111
1000000000000001
1000001001000001
1000N01001000001
1000000000000001
1000000000000001
1000000000000001
1111111111111111
