NO ./textures/north_texture.xpm
SO ./texture/south_texture.xpm
WE ./textures/west_texture.xpm
EA ./textures/east_texture.xpm

C 1, 38, 46

F 1, 38, 46



1111111111111111111111111
1S00000000110000000000001
1011000001110000000000001
1001000000000000000000001
11111111101100000111000001111
10000000001100000111011111111
11110111111111011100000010001
11110111111111011101010010001
11000000110101011100000010001
10000000000000001100000010001
10000000000000001101010010001
11000001110101011111011110001
11110111 1110101 101111010001
11111111 1111111 111111111111
